



     laskjdflkajsddflj
NO ./img/xpm.xp = oui

S    ./img/xpm.xpm
s ./oui.xpm
No ./oui
N ./img/xpm2.xpm

 1
1N1
 1


1111111111111111111
100000000000000000E1
10000000000000000001
10000000000000000001
10000000000000000001
10000000000000000001
11111111111111111111