



     laskjdflkajsddflj
NO ./img/xpm.xp = oui

S    ./img/xpm.xpm
s ./oui.xpm
No ./oui
N ./img/xpm2.xpm

111111111
100000001
100001001
110001001
100011001
100011001
100011001
100001111
1000100N1
111111111