NO ./img/xpm.xpm
S ./img/xpm2.xpm
E ./img/xpm3.xpm
Ef ./img/xpm3.xpm

E ./img/xpm3.xpm


slkdfj
asdflkjlf

asdflkjlf

S ./img/xpm.xpm
F 010,101,256
r 000,111,255
C 0,24,255

o


laskdjf
1111111111
         100NE0001
1000000001
1111111111