



     laskjdflkajsddflj
NO ./img/xpm.xp = oui

S    ./img/xpm.xpm
s ./oui.xpm
No ./oui
N ./img/xpm2.xpm

111111
100001
10N001
100001
111111