



     laskjdflkajsddflj
NO ./img/xpm.xp = oui
F 160,100,200
S    ./img/xpm.xpm
s ./oui.xpm
No ./oui
C 0,0,153
N ./img/xpm2.xpm

1111111111111111111
1010101010101010101
1010101010101010101
1010101010101010101
1010101010101010101
1010101010101010101
1010101010101010101
10000N0000000000001
1111111111111111111