NO ./img/xpm.xpm
S ./img/xpm2.xpm
E ./img/xpm3.xpm
WE ./img/xpm4.xpm
F 000,1f11,222
C 0,24,255

1111111111
1000000001
1000N00001
1000000001
1111111111