



     laskjdflkajsddflj
NO ./img/xpm.xp = oui
F 160,100,200
N    ./texture/mossy.xpm
s ./texture/oak.xpm
S ./texture/oak.xpm
No ./oui
C 123,0,153
E ./texture/obsi.xpm
WE ./texture/stone.xpm

1111111111111111111
1N10101010101010101
1010101010101010101
1010101010101010101
1010101010101010101
1010101010101010101
1010101010101010101
1000000000000000001
       111111111111