oui ./img/xmp.xpm
mais
NO oui


O     ./img/xpm.xpm
n
N            ./img/xpm.xmp
non
EA   prout.xpm
NO ./img/xpm.xpm
CF
F
11
       111111     1111111
1
0
                         1
11111111111111111111        
WE  ./img/xpm.xpm