NO ./texture/mossy.xpm
SO ./texture/oak.xpm
WE ./texture/stone.xpm
EA ./texture/obsi.xpm

F 160,100,200
C 123,0,153

1111111111111111111
1S10101010101010101
1010101010101010101
1010101010101010101
1010101010101010101
1010101010101010101
1010101010101010101
1000000000000000001
1111111111111111111